G0BB000000
0000000000
0000011111
0000011111
0000010001
0000010001
0000010001
0000000000
0000BBBB00
000000000x