0000000G
00010000
00010000
00B10000
00010000
00010000
00000000
00x00000