G0BB00000000000
000000000000000
000000000000000
000001000000000
000001111100000
000001111100000
000001000000000
000001000000000
000001000000000
000001000000000
000001000000000
000001000000000
000001111100000
000000000000000
00000BBBBB00000
00000000000000x
